1111111
1EC0001
1P000c1
1111111