1111111
1EC00E1
1P000c1
1111111