1111111111111111111111
1E00000000000000000001
1010010100100C00101001
1010010010101010001C01
1P0000000C000000000111
1111111111111111111111