1111111111111111111111
1E00000000000000000001
1010010100100000101001
1010010010101010001001
1P0000000C000000000001
1111111111111111111111